AH|安徽省|CHN
BJ|北京市|CHN
CQ|重庆市|CHN
FJ|福建省|CHN
GD|广东省|CHN
GS|甘肃省|CHN
GX|广西壮族自治区|CHN
GZ|贵州省|CHN
HA|河南省|CHN
HB|湖北省|CHN
HE|河北省|CHN
HI|海南省|CHN
HK|香港特别行政区|CHN
HL|黑龙江省|CHN
HN|湖南省|CHN
JL|吉林省|CHN
JS|江苏省|CHN
JX|江西省|CHN
LN|辽宁省|CHN
MO|澳门特别行政区|CHN
NM|内蒙古自治区|CHN
NX|宁夏回族自治区|CHN
QH|青海省|CHN
SC|四川省|CHN
SD|山东省|CHN
SH|上海市|CHN
SN|陕西省|CHN
SX|山西省|CHN
TJ|天津市|CHN
TW|台湾省|CHN
XJ|新疆维吾尔自治区|CHN
XZ|西藏自治区|CHN
YN|云南省|CHN
ZJ|浙江省|CHN